baffled	сбитый с толку
bedrock	основа
beet	свёкла
brittle	хрупкий
burn out	выгореть, сгореть дотла
bushes	кусты
be yourself; everyone else is already taken. oscar wilde.	Будь собой, все остальные роли уже разобраны. Оскар Уальд.
behind every great man is a woman rolling her eyes. bruce almighty.	За каждым великим мужчиной стоит женщина, которая время от времени закатывает глаза. Брюс Всемогущий.
bring me a fat-free yogurt and a cherry marmalade, please.	Принесите мне обезжиренный йогурт и вишнёвый мармелад.
bring us your sorbet and an ice-cream.	Принесите нам щербет и одно мороженое.
but this is an oyster bar: you see it is written up.	Видишь, тут написано, это устричный бар!
ceaseless	непрерывный
chasm	бездна
cheery	весёлый
clonk	глухой металлический звук
cocoa beans	какао бобы
considerably	значительно
consuming	всепоглощающий
crave	страстно желать
cross up	подставить
curiosity	любопытство
calm down	успокаиваться, успокойся!
calm down.	Успокойся.
can i buy you a drink?	Я могу предложить вам выпить?
can i call you some time?	Можно мне звонить тебе время от времени?
can i drive you home (to your place, somewhere)?	Разрешите, я провожу Вас?
can i get some napkins?	Можете принести мне немного салфеток?
can i get you anything to drink?	Могу я принести вам что-нибудь выпить?
can i see a menu in russian, please?	Можно мне меню на русском языке?
can i substitute it with something else?	Я могу заменить это на что-нибудь другое?
can i take early retirement?	Можно мне досрочно уйти на пенсию?
can you bring us some ketchup?	Можете принести нам кетчуп?
cardiac	сердечный
charter	привилегия
clinging	цепляясь
clutching	сжимать
coffee? if it is no bother.	Кофе? Если не трудно.
come on, let's dance!	А ну давай потанцуем!
come on. let's get this over with.	Давай закончим с этим делом.
come to us!	Приезжайте к нам в гости!
come with me!	Пойдемте со мной!
compassion	сострадание
complicated	сложный
could we have more bread, please?	Не могли бы вы принести еще хлеба?
could you please bring us a sponge cake and two dessert forks?	Не могли бы вы принести нам бисквит и 2 десертные вилки?
council	совет
cradling	качать в колыбели
creeping	ползти
crumble	разрушаться
dedication	преданность
dilapidated	полуразрушенный
don't shout at me	не кричите на меня
downright	откровенно
dread	страх
deafening	оглушительный
defamation	клевета
deliverance	освобождение
despite	несмотря на
diamonds are a girl`s best friends. marylin monroe.	Лучшие друзья девушек — это бриллианты. Мэрилин Монро.
do they serve a vanilla creme brulee here?	У них подают ванильный крем-брюле?
do we know each other?	Мы с вами не знакомы?
do you fancy going out tonight?	Хочешь прогуляться сегодня вечером?
do you have a boyfriend?	У вас есть парень?
do you have a girlfriend?	У вас есть девушка?
do you have a light?	У вас огонька не найдется?
do you have a reservation?	У вас заказан столик?
do you have a well-paid job?	У вас есть хорошо оплачиваемая работа?
do you know what time is it?	Вы не знаете, сколько время?
do you like the music?	Тебе нравится эта музыка?
do you like to meet new people?	Тебе нравится встречаться с новыми людьми?
do you need staff for your next project?	Вам нужны сотрудники на ваш следующий проект?
do you prefer still or sparkling water?	Вы предпочитаете воду без газа или с газом?
do you smoke?	Вы курите?
do you speak english?	Вы говорите по-английски?
do you want me to help you? you bet!	Ты хочешь, чтобы я помог тебе? Еще спрашиваешь!
do you want pancakes with your order?	К вашему заказу добавить блины?
do you want to bring anybody along?	Хотите ли Вы взять с собой кого-нибудь?
do you want to dance?	Хочешь ли потанцевать?
do you work freelance?	Вы занимаетесь фрилансом?
don't be late, please!	Не опаздывайте, пожалуйста.
don't be silly.	Не глупи. Не дури.
don't mention that.	Не надо об этом.
don't worry, i can make it on my own.	He волнуйтесь, я сам справлюсь.
don't worry. relax.	He волнуйся. Успокойся. Расслабься.
don't you eat grilled lobsters and crabs?	Резве ты не ешь лобстеров и крабов на гриле?
e-mail your cv to us, please.	Пожалуйста, отправьте нам ваше резюме по почте.
efforts	усилия
empathy	сочувствие
estimate	оценивать
easy!	Полегче. Не лезь на рожон. Успокойся.
elucidation	разъяснение
estimation	подсчёт
eventually	в конечном итоге
every evening i died and every evening i was born again. the fight club.	Каждый вечер я умирал и каждый вечер я рождался заново. Бойцовский клуб.
exact	точный
faithfulness	верность
fallacy	заблуждение
ferocious	свирепый
fidget	ерзать
fuses	предохранители
fuss	суета
fear is the enemy of logic. frank sinatra.	Страх — враг логики. Фрэнк Синатра.
fired	уволен
for my entree, i'll have carpaccio of beef with parmesan.	В качестве закуски я съем карпаччо из говядины с пармезаном.
forgive your enemies, but never forget their names. john f. kennedy.	Можете забыть о своих врагах, но помните их имена. Джон Ф. Кеннеди.
frankly, my dear, i don`t give a damn. rhett butler.	Если честно, моя дорогая, мне наплевать. Ретт Батлер.
garb	одеяние
get out of here	убирайся отсюда
gnats	москиты
grief	горе
groan	стонать
gut	Характер, сила воли
get lost.	Исчезни. Мотай отсюда. Проваливай.
get out of my way.	Уйди с дороги.
glad to meet you.	Приятно познакомиться.
gold ore	Золотая руда
gradually	постепенно
guess	догадываться
hangover	разг. похмелье
harps	арфа
hesitate	колебаться
hoe	мотыга
hung	повесил
have you received your dole money yet?	Ты еще не получил пособие по безработице?
haven't we met before?	Разве мы раньше не встречались?
hear me out!	Выслушайте меня!
hence	следовательно
here's what we'll do.	Мы сделаем вот что.
heritage	наследие
hi, mike! i like your profile. do you think we can talk a little bit?	Привет, Майк! Мне понравилась твоя анкета. Как ты думаешь, мы можем поболтать немного?
how about a shortcake for dessert, jane?	Джейн, как насчёт слоёного торта с фруктовой начинкой на десерт?
how about some coffee or tea?	Как насчёт кофе или чая?
how are you?	Как дела?
how do you like to spend your free time?	Как ты любишь проводить свободное время?
how many hours a day do you work?	Сколько часов в сутки вы работаете?
how old are you?	Сколько Вам лет?
however	однако
humanity is overrated. house m.d..	Гуманизм переоценен. Доктор Хаус.
i agree that strawberry truffles were awesome.	Я согласна, клубничные трюфели были великолепными.
i always tell the truth, even when i lie. scarface.	Я всегда говорю правду, даже когда лгу. Лицо со шрамом.
i am a businessman.	Я - бизнесмен.
i am away on holiday for the next two weeks.	Я в отпуске следующие две недели.
i am from russia.	Я приехал из России.
i am glad to meet you!	Рад встрече.
i bet i know your name.	Держу пари, я знаю как Вас зовут.
i can add chocolate, vanilla or caramel flavouring.	Я могу добавить шоколадный, ванильный или карамельный сироп.
i can resist everything except temptation. oscar wilde.	Я могу устоять перед всем, кроме соблазна. Оскар Уальд.
i can serve you a soda or a raspberry punch, if you like.	Могу предложить вам газированную воду или малиновый пунш, если хотите.
i can't cope with the workload. may i share it with you?	Я не могу справиться со всем объемом работы. Можно я отдам часть тебе?
i can't take my eyes off you.	Я не могу отвести глаз от тебя.
i could bring you your shrimp cocktail now.	Я могу принести вам сейчас коктейль из креветок.
i couldn't reach you.	Я не мог дозвониться до тебя.
i don't eat meat.	Я не ем мясо.
i don't give a damn.	Мне до лампочки.
i don't like myself, i'm crazy about myself. mae west.	Я не нравлюсь себе, я без ума от себя. Мэй Уэст.
i don't like when fried chicken wings are too spicy.	Мне не нравится, когда жареные куриные крылышки слишком острые.
i don't like wine, i prefer a lemon squash.	Я не люблю вино, я предпочитаю содовую воду с лимонным соком.
i don't mind.	Я ничего не имею против.
i don't understand you.	Я не понимаю Вас.
i felt that the food was pretty mediocre and overpriced.	Я чувствовал, что еда здесь посредственная и слишком дорогая.
i have a 10 hour workday.	У меня десятичасовой рабочий день.
i have never let my schooling interfere with my education. mark twain.	Я никогда не позволял школе вмешиваться в моё образование. Марк Твен.
i have no job satisfaction. i'm going to leave.	Моя работа не приносит удовлетворения. Я собираюсь уйти.
i haven't given it much thought.	Я пока еще не думал об этом.
i love sunny-side up eggs with a piece of toast.	Я обожаю яичницу с кусочком тоста.
i love the way your luminous eyes flash.	Мне нравится, как сверкают твои прекрасные глаза.
i mean it.	Честное слово. Я говорю искренне.
i meant only the best.	Я хотел только как лучше.
i start my shift at 8 a.m.	Моя смена начинается в восемь утра.
i think i ordered a cup of decaffeinated coffee.	Мне кажется, я заказывал кофе без кофеина.
i think about we should leave a 15 percent tip.	Я думаю, нам нужно оставить 15 процентов чаевых.
i think so.	Я так думаю.
i think we can meet and spend some time together.	Думаю, мы можем встретиться и провести какое-то время вместе.
i think you forgot to bring me a fork.	Я думаю, вы забыли принести мне вилку.
i want to buy your house. i mean it.	Я хочу купить ваш дом. Честное слово.
i want to find my vocation.	Я хочу найти свое призвание.
i want to know god's thoughts; the rest are details. albert einstein.	Я хочу знать, о чем думает Бог, все остальное — детали. Альберт Эйнштейн.
i want to put a ding in the universe. steve jobs.	Я хочу оставить свой след во Вселенной. Стив Джобс.
i want to try your cheeseburger.	Я хотел бы заказать чизбургер.
i want to wake up in the city that never sleeps. frank sinatra.	Я хочу просыпаться в городе, который никогда не спит. Фрэнк Синатра.
i want to work part-time.	Я хочу работать неполный рабочий день.
i was headhunted by a marketing agency.	Меня отобрали для работы в маркетинговом агентстве.
i was sacked for being drunk.	Меня уволили за явку в нетрезвом виде.
i was you and never knew it. rumi.	Я был тобой и никогда не знал этого. Руми.
i will be off-duty on thursday.	Я не дежурю в четверг.
i'd be glad to see you.	Буду рад Вас видеть.
i'd just wanted to tell you that..	Я лишь хотел сказать Вам, что..
i'd like an apple juice, bacon and eggs.	Принесите мне яблочный сок, бекон и яйца.
i'd like to get to know you much better.	Хотелось бы узнать тебя получше.
i'd like to invite you to the theatre.	Я хочу пригласить Вас в театр.
i'd like to see the job description.	Я хотел бы посмотреть список должностных обязанностей.
i'd like to take a few days off.	Я бы хотел взять несколько отгулов.
i'd like to talk to the human resources director.	Я бы хотел поговорить с начальником отдела кадров.
i'd love to eat a chocolate mousse with whipped cream.	Я с удовольствием бы съела шоколадный мусс со взбитыми сливками.
i'd love to try a pecan-caramel ice cream today.	Я бы с удовольствием попробовала мороженое c карамелью и орехом пекан.
i'll be in time.	Я буду вовремя.
i'll gain the necessary qualifications and apply for this job again.	Я получу необходимые навыки и снова попробую получить эту работу.
i'll go shopping during my lunch break.	Я пойду по магазинам в обеденный перерыв.
i'll have a cup of cappuccino.	Я бы выпила чашку капучино.
i'll try asparagus and marinated mushrooms as a salad.	Я попробую салат из спаржи и маринованных грибов.
i'll wait for you on that side of the street.	Я подожду Вас на другой стороне улицы.
i'm a lawyer.	Я юрист.
i'm actively engaged in voluntary work.	Я активно занимаюсь волонтерской деятельностью.
i'm afraid we were out of pineapple juice.	Боюсь, у нас нет ананасового сока.
i'm jobless.	Я безработный.
i'm looking for a job.	Я ищу работу.
i'm looking forward to meeting you.	С нетерпением жду встречи с Вами.
i'm on a diet, please bring me a piece of rye bread.	Я на диете, пожалуйста, принесите мне кусочек ржаного хлеба.
i'm really grateful to you.	Я очень Вам благодарен.
i'm so happy! i have been called for an interview today.	Я так счастлив! Меня позвали на собеседование сегодня.
i'm so hungry, bring me a smoked salmon with crispy polenta.	Я такой голодный, принесите мне копчёного лосося с хрустящей полентой.
i'm too handsome to do paperwork. house m.d..	Я слишком красив, чтобы заниматься бумажной работой. Доктор Хаус.
i'm travelling on business.	Я в командировке.
i'm trying to achieve a better work-life balance.	Я стараюсь достичь баланса между работой и личной жизнью.
i'm very sorry, but you lack experience.	Мне очень жаль, но у вас недостаточно опыта.
i've been downgraded from principal to vice-principal.	Меня понизили с директора до замдиректора.
i've dropped my spoon, bring me another one.	Я уронил ложку, принесите мне другую.
i've read the things you like... you won't believe i like all of those things too!	Прочитала чем ты интересуешься... Ты не поверишь, но мне нравится тоже самое!
ide	интегрированная среда разработки
ifrit	ифрит
incredulous	недоверчивый
induce	побуждать
initiatives	инициативы
inocent	Невинный
investigation	Расследование
ivy	плющ
i`ll think about that tomorrow. scarlett o`hara.	Я подумаю об этом завтра. Скарлетт О`Хара.
if it sells, it's art. frank lloyd.	Если это продается, то это искусство. Френк Ллойд.
if you are going through hell, keep going. winston churchill.	Если ты идешь через ад, продолжай идти. Уинстон Черчилль.
if you have nothing to say, say nothing. mark twain.	Не говори ничего, если тебе нечего сказать. Марк Твен.
if you haven't found it yet, keep looking. steve jobs.	Если вы еще не нашли свое дело, продолжайте искать. Стив Джобс.
if you're good at something never do it for free. joker, batman dark knight.	Если ты делаешь что-то хорошо, никогда не делай это бесплатно. Джокер, Темный рыцарь.
in spite	не смотря на
in this world, nothing is certain but death and taxes. meet joe black.	Неизбежны лишь смерть и налоги. Знакомьтесь, Джо Блэк.
integrated development environment	интегрированная среда разработки
is it table service or self-service?	Этот столик обслуживается или надо самим заказывать?
is this time suitable for you?	Это время Вам подходит?
it beats me.	Это выше моего понимания.
it is combined with butter and worcestershire sauce.	Это блюдо сочетается с маслом и вустерширским соусом.
it is lovely weather today, isn't it?	Сегодня прелестная погода, не правда ли?
it makes things easier.	Так проще.
it never crossed my mind that we would find this treasure.	Мне никогда не приходило в голову, что мы найдем это сокровище.
it never occurred to me to ask where she'd been.	Мне никогда не приходило в голову спросить, где она была.
it serves you right.	Так тебе и надо.
it was not that he didn't love her.	He то, чтобы он не любил ее.
it's a nice day, we prefer to eat outside.	Сегодня хорошая погода, мы бы предпочли поесть на террасе.
it's going to be all right.	Все будет хорошо.
it's not that i want to stay here.	Нельзя сказать, что я хочу здесь остаться.
jaded	измученный
jarred	дребезжал
jerk	придурок, болван
jolt	толчок
kidding	шутить
kate, haven't you got any english mustard?	Кейт, нет ли у вас английской горчицы?
keep your friends close, but your enemies closer. michael corleone, godfather.	Держи друзей близко, а врагов еще ближе. Майкл Корлеоне, Крёстный отец.
laced	переплетен
lan	локальная вычислительная сеть
lava	лава
lcd	жидкокристаллический индикатор
leaf-strewn	усыпанный листвой
leaning	наклоняясь
leave me alone	оставь меня в покое. /....одного/
ledge	выступ
lf line feed	перевод строки
lgpl	стандартная общественная лицензия ограниченного применения
lifo	последним пришёл - первым обслужен
limply	безвольнo
litany	унылый перечень
lsb	младший (наименее значащий) бит байта или машинного слова
lurch	идти шатаясь
last in first out	последним пришёл - первым обслужен
least significant bit	младший (наименее значащий) бит байта или машинного слова
lesser gpl	стандартная общественная лицензия ограниченного применения
let happen whatever would happen.	Пусть будет, что будет.
let's exchange e-mails / phone numbers.	Давайте обменяемся e-mail/телефонными номерами.
let's fix a meeting.	Давайте договоримся о встрече.
let's fix the exact time and place.	Давайте договоримся о точном времени и месте.
let's get to the point. let's hold to reason.	Давайте ближе к делу.
let's go to the seafood restaurant.	Пойдемте в рыбный ресторан.
let's try mozzarella fried sticks here.	Давай попробуем здесь сырные палочки из моцареллы.
let’s go to the cinema!	Давайте пойдем в кино!
life is a ticket to the greatest show on earth. martin h. fischer.	Жизнь — это билет на величайшее шоу на земле. Мартин Х. Фишер.
light music is a nice addition to delicious meal.	Ненавязчивая музыка - приятное дополнение к вкусной еде.
light-emitting diode	светодиод
lightweight directory applications protocol	протокол, обеспечивающий доступ к несовместимым между собой каталогам
linux security modules	интерфейс модулей безопасности
liquid-crystal display	жидкокристаллический индикатор
live for nothing or die for something. rambo.	Живи ни для чего, или умри за что-то. Рэмбо.
local area network	локальная вычислительная сеть
look, i've just realised that you look a lot like a girl of my dreams.	Слушай, до меня только что дошло, что ты очень похожа на девушку моей мечты.
menacing	грозный
mourner	скорбящий
mustard pot	горчичница
make a banana lime smoothie for me, please.	Сделайте, пожалуйста, смузи из банана с лаймом.
make a thin and crispy crust for the hawaiian pizza.	Сделайте у гавайской пиццы тоненькую хрустящую корочку.
marriage is our last, best chance to grow up. joseph barth.	Брак — наш последний, и самый лучший шанс повзрослеть. Джозеф Барт.
may i ask you out?	Можно пригласить Вас на свидание?
may i get a glass of lemonade with cherries?	Можно мне стакан вишнёвого лимонада?
may i have the pleasure of a dance?	Не доставите ли вы мне удовольствие, потанцевать со мной?
may i have your phone number or skype?	Можно взять у тебя номер телефона или скайп?
may the force be with you. star wars.	Да прибудет с вами сила. Звездные войны.
meanwhile	тем временем
money is a poor man's credit card. marshal mcluhan.	Деньги — это кредитная карточка бедного человека. Маршал Маклюэн.
much obliged.	Весьма признателен.
musing	размышляя
my annual salary is not very high.	Моя годовая зарплата не слишком высокая.
my boss offered me a promotion.	Начальник предложил мне повышение.
my co-workers are very nice people.	Мои коллеги очень милые люди.
my coffee is not hot.	Мой кофе не горячий.
my fish is too salty.	Моя рыба пересолена.
my friends will drink freshly squeezed orange juice.	Мои друзья будут пить свежевыжатый апельсиновый сок.
my heart overflows with love for you.	Моё сердце переполняется любовью к тебе.
my parents are pensioners.	Мои родители пенсионеры.
my wife and i'll split a pasta dish and beef curry.	Моя жена и я поделим между собой блюда из пасты и говядины с карри.
nodded	кивнул
never hate your enemies, it affects your judgement. godfather.	Не стоит ненавидеть врагов — эмоции мешают думать. Крестный отец.
never, never, never give up! winston churchill.	Никогда, никогда, никогда не сдавайся! Уинстон Черчилль.
nice to have met you.	Приятно было с вами познакомиться.
no reason in particular.	Просто так. Без особой причины.
not likely. unless you want to continue our discussion.	Скорей всего, нет. Если только ты не хочешь продолжить нашу дискуссию.
nothing ventured, nothing gained	кто не рискует, тот не пьет шампанского
numbing	онемевший
ocelot	оцелот
offend	обижать
oh my gosh	Боже мой!
overwhelmed	ошеломлённый
oh, and i've wrapped up the leftover barbecued chicken.	Да, кстати, остался жареный цыплёнок, я его завернула в фольгу.
one dry sherry and a glass of champagne, please.	Один сухой шерри и бокал шампанского, пожалуйста.
our company is overstaffed.	В нашей компании слишком много сотрудников.
our family prefer only healthy, organic food.	Наша семья предпочитает здоровую, натуральную пищу.
pandemonium	столпотворение
panem	хлеба и зрелищ!
patronizing	высокомерный
plate	пластина
plopped down	плюхнулась
pudgy	коротенький и толстый
putrid	гнилой
parable	притча
perhaps	возможно
pixel	пиксель
please give your name, address, and occupation.	Пожалуйста, укажите ваше имя, адрес и род деятельности.
please tell me about the specials of the day.	Пожалуйста, расскажите мне о блюде дня.
proud	гордый
purified	очищенный
quitter	лодырь
rapture	восторг
rattling	грохочущий
reached down	нагнулся
reeked	дурно пахло
reeling	кружиться
refuge	убежище
revel	наслаждаться
rumbling	грохот
reach out	протянуть руку, добиться
reconcile	согласовывать
redemption	искупление
refresher	памятка
reminisce	предаваться воспоминаниям
restless	беспокойный
sag	провисать
sank	опуститься
seeds	семена
shank	стержень
shit	дерьмо
shook	тряс
shove	запихнуть
shovel	лопата
shrugged	пожал плечами
shudder	вздрагивать
slamming	захлопывать
slid	скользнул
slug	слизняк
smear	мазать
smears	размытость
smothering	подавляющий
solace	утешение
son of a bitch	сукин сын
soothe	утешать
spruce	ель
staggered	поражeн
stairs	ступеньки
stepped up	активизировали, подошёл
stings	укус
strangely enough	как ни странно
striking	поразительный
struck	ударять
swam out	выплыл
swaying	раскачивание
swept away	сметены
swings	качается
swiveled	вертевший
sword	меч
swung	повернулся
sanity	здравомыслие
seek out	разыскивать, отыскать
seeping	просачиваться
several	несколько
severed	разорвал
show must go on. queen.	Шоу должно продолжаться. Queen.
sneering	насмешливо
so far so good.	Пока что все идет хорошо.
so how do you two know each other?	Так откуда вы знаете друг друга?
so that's one seafood spaghetti, one hamburger and one coke.	Итак, одна порция спагетти с морепродуктами, один гамбургер и кока-кола.
sometimes i work overtime.	Иногда я работаю сверхурочно.
sounds good to me.	Это меня устраивает.
spend	тратить
stolen	украл
stranger	незнакомец
suit yourself, but i've got a work to do and i won't go to paris.	Воля ваша, но мне нужно кое-что сделать, и в Париж я не поеду.
suit yourself.	Как хочешь. Воля ваша. Делай, как знаешь.
swear up	поклялся
tempt	соблазнять
tiptoed	на цыпочках
truce	перемирие
tell him whatever you want, i don't give a shit.	Можешь говорить ему все, что угодно — мне до лампочки.
tend to your own affairs.	Лучше займись своими делами. Не лезь не в свое дело.
terrified	в ужасе
thank you for a nice day.	Спасибо за прекрасный день.
thank you for your compliment.	Спасибо за комплимент.
that's a good idea.	Это хорошая идея.
that's the whole point.	В том-то все и дело.
the chef would be happy to meet your gastronomic tastes.	Шеф-повар с удовольствием исполнит ваши гастрономические капризы.
the crab salad to start, and the fillet of sea bass to follow.	Сначала принесите крабовый салат, а потом филе из морского окуня.
the day had brightened considerably.	день был значительно ярче.
the only way to have a friend is to be one. ralph waldo emersen.	Единственный способ иметь друга — стать другом. Ральф Уольдо Эмерсен.
the total price for your dinner is 50.00$.	Общая стоимость вашего обеда составляет 50 долларов.
there is no sin except stupidity. oscar wilde.	Нет большего греха, чем глупость. Оскар Уальд.
there is only one happiness in life — to love and to be loved. george sand.	Единственное счастье в жизни — любить и быть любимым. Жорж Санд.
there is too much pepper in the soup.	В этом супе слишком много перца.
there was a whole dish of hot pies smelling of jam, rice, and fish.	Подали полное блюдо горячих пирожков, от которых пахло вареньем, вареным рисом и рыбой.
these carrot chips are so crispy.	Эти чипсы из моркови такие хрустящие.
they are going to reduce the workforce.	Они собираются сократить штат сотрудников.
think it over.	Подумай хорошенько.
this banana cocktail looks lovely.	Этот банановый коктейль смотрится восхитительно.
this cheese omelette is very good.	Этот омлет с сыром очень вкусный.
time's up.	Время вышло.
to be or not to be, that`s the question. hamlet.	Быть или не быть; вот в чем вопрос. Гамлет.
treaty	договор
trick or treat	кошелёк или жизнь
truth begins in lies. house m.d..	Правда начинается со лжи. Доктор Хаус.
try to get letters of recommendation from bosses.	Постарайся получить рекомендательные письма от начальства.
two o'clock is the best time for me.	Два часа для меня в самый раз .
unease	беспокойство
utter	абсолютный
unearth	раскопать
vainly	тщетно
vanity	суета
vicious	порочный
villain	злодей
vomited	блевал
very well.	Очень хорошо.
wax	воск
what a jerk	Какой болван!
wages are paid on fridays.	Зарплату платят каждую пятницу.
we are out of the beef stew today, but we have a wide choice of starters.	У нас сегодня нет в наличии рагу из говядины, но есть большой выбор первых блюд.
we could have a cup of coffee at my place.	Давайте попьем кофе у меня.
we could meet at 5 o'clock.	Мы можем встретиться в 5 часов.
we have a huge selection of local beer.	У нас большой выбор местного пива.
we have a wide choice of soft drinks.	У нас большой выбор безалкогольных напитков.
we have limited selection of pasta dishes, but they are quite good.	У нас ограниченный выбор блюд из макарон, но эти блюда очень вкусные.
we have soft-boiled eggs and ham for breakfast.	Мы едим на завтрак яйца всмятку и ветчину.
we ordered well-done steaks, and these are rare.	Мы заказали хорошо прожаренный бифштекс, а нам принесли его с кровью.
we'll take an order of mushroom puffs.	Мы закажем слоёные булочки с грибами.
we'll take two hamburgers.	Мы возьмём два гамбургера.
what a charming girl you are!	Какая ты очаровательная девушка!
what are you?	Кем вы работаете?
what are your duties?	Каковы ваши обязанности?
what if we meet?	Может быть, встретимся?
what is your name?	Как Вас зовут?
what ruined your career?	Что разрушило вашу карьеру?
what salad would you recommend?	Какой салат вы бы порекомендовали?
what time is good for you?	Какое время Вам подходит?
what toppings do you offer today?	Какие начинки у вас сегодня в наличии?
what's the phone number of the employment centre?	Какой номер у центра занятости?
whatever is to be will be.	Чему быть, того не миновать.
when do you usually arrive at?	Во сколько вы обычно приходите на работу?
where do you come from?	Откуда Вы?
where would you like to meet?	Где бы ты хотела встретиться?
who are you and where are you from?	Кто ты и откуда ты?
who are you by profession?	Кто вы по профессии?
why do you ask? no reason in particular.	Почему ты спрашиваешь? Просто так.
will you say that again, please?	Повторите еще раз, будьте добры
with bigger powers come bigger responsibilities. spider man.	Чем больше сила, тем больше ответственность. Человек—паук.
without friends no one would choose to live. aristotle.	Никто не согласился бы жить без друзей. Аристотель.
without you there's no sun in the sky.	Без тебя для меня нет солнца в небе.
would you care for another piece of plum pudding, miss?	Не хотите ли вы еще кусочек сливового пудинга, мисс?
would you like a drink with your vegan salad?	Вы возьмете какой-нибудь напиток к вегетарианскому салату?
would you like a ham or a tuna sandwich?	Вы бы хотели сэндвич с ветчиной или тунцом?
would you like to order an aperitif before dinner?	Вы бы хотели заказать аперитив перед ужином?
would you like your brandy neat or on the rocks?	Вам принести неразбавленный бренди или со льдом?
yesterday i was offered the post of ambassador to india.	Вчера мне предложили должность посла в Индии.
you are on the right track.	Вы на правильном пути. Вы правильно мыслите.
you bet!	Еще спрашиваешь!
you have a point there.	Тут вы правы. Тоже верно.
you have to improve your practical skills.	Вам нужно улучшить практические навыки.
you have wonderful taste in clothes.	У Вас великолепный вкус в одежде.
you know better than that.	А ты не так прост.
you look fantastic!	Ты великолепно выглядишь!, Ты выглядишь чудесно!
you may wish to have a snack.	Возможно, вы захотите перекусить.
you need a professional to sort out your finances.	Вам нужен профессионал, чтобы разобраться с вашими финансовыми делами.
you smell so good!	Ты так хорошо пахнешь!
you'll hear from me.	Я дам вам знать.
you'll make it.	Ты сделаешь это.
you`re the worst thing that`s ever happened to me. marla singer, fight club.	Ты худшее, что было в моей жизни. Марла Сингер, Бойцовский клуб.
your beautiful eyes have set my heart at fire.	Твои прекрасные глаза разжигают огонь в моём сердце.
your hair is so soft!	У тебя такие мягкие волосы!
your smile makes a bright day even brighter.	Твоя улыбка делает яркий день ещё ярче.
your time is limited, so don't waste it living someone else's life. steve jobs.	Ваше время ограничено, поэтому не тратьте его, живя чужой жизнью. Стив Джобс.
a tinge of annoyance	некоторым оттенком раздражения.
abducted	похищенные
aberration	заблуждение, аберрация
able	способный
aboard	вдоль
abruptly	внезапно
abundant	имеющийся в изобилии
abuse	оскорблять
access	доступ
accidentally	случайно
accomplish	достигать
accusations	обвинения
aching	болящий
acquire	приобретать
acquit	оправдывать
actual	фактический, реальный, действующий
admiration	восхищение
adoption	усыновление
adorable	очаровательный
adoration	обожание, благоговение
advantageous	благоприятный
adversity	несчастья
advise	советовать
affairs	дела
affection	привязанность
afford	позволить себе
affordable	возможный
against	против
air-photography	аэрофотосъёмка
aisle	проход
algorithm	алгоритм
allege	утверждать
allegedly	якобы
aloft	наверху
alone	одинокий
aloof	отчуждённый
ambitions	амбиции
among	среди
amorousness	влюбчивость
amusement	изумление
anger	гнев
angry mood	злоба
ankle	лодыжка
annoy	раздражать
anodyne	успокаивающий
another	ещё один, другой, новый
anthem	гимн
anxious	озабоченный
apathy	апатия
aperture	отверстие
aperture number	число диафрагмы
aplomb	уверенность
apparently	вероятно
appendage	придаток
appliances	бытовая техника
appraisal	оценка
appreciated	оценивать
appreciation	признательность
apprehension	опасение; мрачное предчувствие, тревога
approaching	приближение
approximately	приблизительно
arbitrary	произвольный
are you crazy	ты сумасшедший
area coverage	покрытие местности
argue	спорить
arid	сухой
armpit	подмышка
arrogance	высокомерие
ashamed	пристыжённый
assailants	нападающие
assault	нападение
assessment	оценка
assume	допускать
astonish	удивлять
asylum	убежище
atmospheric transmittance	прозрачность атмосферы
attempt	пытаться
attendant	слуга
auto exposure control	автономное регулирование экспозиции
autography	автография
autoplug	автовилка
avalanche	лавина
avarice	алчность
avert	предотвращать
aware	осведомлённый
awe	страх, трепет
awful	ужасно
awkward	неуклюжий
axe	топор
back light	контровый свет
back-of-the-envelope	предварительный, черновой, приблизительный
backbone	позвоночник
bad	дурной, плохой, скверный
bail	залог
bald head	лысина
bare	голый
barely	едва
bark	кора
basic	главный, базовый, основной
basin	миска
bath-towel	махровое полотенце
battery	элементы питания
be over	окончиться, завершиться
bear	терпеть
bearing	поведение
beast	зверь
beaten up	избит
beef	говядина
befit	соответствовать
beg	просить
belly	живот
belt	пояс
bend	сгибать
beneath	под
benefactor	благодетель
berth	койка
besom	веник
best	лучший
betray	предавать
better	лучший, наилучший
beware	остерегаться
beyond	за
bickering	пререкания
big	большой, крупный, высокий, широкий, громкий
bill	счет
birthmark	родимое пятно
bite	кусать
bitter	горький
bizarrely	странно
black	чёрный, тёмный
blame	обвинять
blanket	шерстяное одеяло
bleach	побелеть
bleached	выцветший
blessings	благословения
bliss	блаженство
block	блок, кубик, многоквартирный дом
blood vessel	кровеносный сосуд
blow out	разбиться вдребезги, гаснуть
blue	голубой
blush	краснеть
board	плата
bogart	присвоить
boiled	варёный
bond	связь
bored	скучающий
boredom	скука
borrower	заёмщик
borrowing	заимствование
bother	беспокоиться
brace	приготовьтесь
brand-new	совершенно новый
brave heart	храброе сердце, смельчак, храбрец, бесстрашный человек
bribes	взятки
bride	новобрачная невеста
broke out	вспыхнуть, внезапно начаться
broom	метла
brown	коричневый
bucket	ведро
buckle down	стать серьёзным; приложить усилия; сосредоточиться
buddy	приятель
buildup	наращивание
bulletproof	пуленепробиваемый
bum	бездельник
bunch	связка
burden	бремя
bureau	бюро
buried	похоронен
burst out	воскликнуть, разразиться (смехом и т.п.), вырваться
buster	придурок
busy	деятельный; занятой
butter	сливочное масло
by and by	Вскоре, в конце концов
byte	байт
caged	запертый
calf	икра (ноги)
camera	фотоаппарат
camera body	корпус
candle	свеча
canine	клык
capable	способный
capper	кульминация или высшая точка чего-либо
carefree	беззаботный
caress	нежность
carry on	продолжать заниматься чем-либо
carry out	выполнять, осуществлять (приказ, обещание и т.п.)
cast	бросать
cause	причина
cautious	осторожный
cavity	полость
central	главный, руководящий, центральный, важный
cerebrum	головной мозг
certain	точный, определённый
chandelier	люстра
characteristic curve	характеристическая кривая
charcoal	древесный уголь
charming personality	харизматическая, притягательная личность
cheerfully	весело
cherish	ухаживать
chill	холод
chin	подбородок
choke	задыхаться
chuck pulled himself up to lean on an elbow, looking at thomas.	Чак подтянулся, чтобы опереться на локоть, глядя на Томаса.
churning	взбалтывать
cigarette butt	окурок
circumstances	обстоятельства
claim	требовать
clamp	зажимать
clashes	конфликт
class	класс
clavicle	ключица
clear	светлый, ясный, прозрачный, чёткий
clench	сжимать
clever	умный
cloak	плащ
close your mouth	закрой свой рот
clue	улика
clumsy	неуклюжий
clunky	неуклюжий
cluster	кластер
coal	уголь
cobwebs	хитросплетения
code	код
cold	холодный
collusion	тайное соглашение
come by	заходить, приходить
common	общий, всеобщий, публичный, распространённый
commonly	обычно
complacent	самодовольный
complain	жаловаться
complains	жаловаться
complete	полный, целый, законченный, завершённый
compulsion	принуждение
computer	компьютер
computing	вычисление
conceal	скрывать
conceivable	мыслимый
concerned	озабоченный, встревоженный
concession	уступка
concise	краткий
concrete	бетон
condemned	осуждённый
condition	состояние
confession	признание
confide	доверять
confidence	уверенность
configuration	конфигурация
confine	ограничивать
confusion	замешательство
conjurer	фокусник
conscience	совесть
consciously	сознательно
consciousness	сознание
consequences	последствия
considerable	значительный
considering	принимая во внимание
consolation	утешение
constellation	астр. созвездие, астр. созвездие
constructor	конструктор
consumes	потребляет
consumption	потребление
contact method (of printing negative)	контактный способ
contagious	заразный
contingency	непредвиденное обстоятельство
contrast	контраст
convenient	удобный
conviction	уверенность
convince	убеждать
cool off	остыть, взять себя в руки, успокоиться, охладиться
cope	справиться
copy equipment(positive print from negative)	копировальный прибор
corona	ореол
correct	правильный, соответствующий, надлежащий
cosy	уютный
counseling	консультирование
countless	бесчисленный
coursing	течёт
court order	распоряжение суда
crackdown	карательные меры
crap	дерьмо
craving	страстное желание
creepy	жуткий
cringe	съёживаться
crocheted	вязаный
crowds	толпа
cruel	жестокий
crummy	отвратительный
crunch	хруст
crypt	склеп
cuddle up	прижиматься к кому-либо
culling	отбор
culprits	виновники
curious	любопытный
cushion	диванная подушка
customization	настройка
daintily	изящно
daisy	маргаритка
damn	черт побери
damnation	проклятие
dangle	свисать
dare	отважиться
dark	тёмный
darling	дорогой-ая
data panel	контрольный экран
database	база данных
dawn	рассвет
dazzled	изумлять
debug	отлаживать (программу)
debugger	отладчик (программа для отладки кода)
decadence	упадок
decapitate	обезглавливать
decay	разложение
deceiver	обманщик
decision	решение
decisions	решение
dedicate	посвящать, предназначать
deem	полагать
deep	глубокий
defy	бросать вызов
delicious	приятный
delightful	восхитительный, очаровательный
delusion	заблуждение
demeans	унижать
densitometer	денситометр
deny	отрицать
departure	отправление
depth of field	глубина резкости
deputy	заместитель
deserve	заслуживать
desire	желание
despair	отчаяние
desperate	отчаянный
destructor	деструктор
deuce	двойка
develop	разрабатывать, проявлять/проявить
developer	разработчик, проявитель
developing	разработка
developing equipment	проявочная аппаратура
devoted	преданный
devotion	преданность
devour	пожирать
diamond	алмаз
diamond ore	алмазная руда
different	непохожий, другой, отличный
diffused light	рассеянный свет
digestion	пищеварение
digital zoom	цифровой зум
dignity	достоинство, гордость
diligence	усердие
diluted	разбавленный
dimensioning	масштаб
dimple	ямка(на щеке)
din	шум
direct	прямой, непосредственный; непрерывный, откровенный
directly	прямо
dirty (used) developer	проявитель, загрязнённый
disappointment	разочарование
disaster	катастрофа
disbelief	неверие
disease	болезнь
disguise	маска
disgust	отвращение
disgustedly	с отвращением
diskette	дискета
disperses	рассеивается
disport	развлекаться
disquieting	тревожный
dissatisfaction	недовольство
distinctive	отличительный
distinguish	различать
distributed system	распределенная система
diversity	разнообразие
divine	божественный
divorced	разведённая
dizziness	головокружение
dizzy	испытывающий / чувствующий головокружение
do you think you're doing?	вы думаете, что вы делаете?
dog	собака
don't be stupid	не валяй дурака
doubt	сомнение
doubtful	сомневающийся
dove	голубь
dozens	множество
drab	однообразие
drawer	выдвижной ящик (стола
drawing-room	гостиная
draws	подходить
dripping	промокший
drive mode	режим съемки
dross	мусор
dry	сухой, обезвоженный, скучный, непредвзятый, беспристрастный
drying room	сушильное помещение
dubs	ссылаться (на что-л.)
dull	скучный
dummy	ламер
during	во время
eager	интенсивный, напряжённый, азартный
early	ранний, начальный
earrings	сережки
easy	лёгкий, нетрудный, естественный, спокойный, уравновешенный, спокойно, легче
effort	усилие
either	каждый
elated by success	окрылённый успехом
elbow	локоть
elk	лось
eloquent	красноречивый
embarrass	смущать
embarrassed	смущённый; сконфуженный
embodiment	олицетворение
embrace	объятие
embraced	использовать
emerge	появляться
emphasize	подчёркивать
empty	пустой
enamel	зубная эмаль
encasing	покрытие
encourages	поощрять
endeavours	старания
endless paradise	бесконечные рай
endorse	подтверждать, одобрять
enduring	выносливый
engaged	поглощенный
enigmatic	загадочный
enlarger	фотоувеличитель
enormous	огромный
enthusiastic	восторженный; полный энтузиазма
enticed	заманил
enticing	соблазнительный
entire	полный, целый, весь
envision	воображать
epiphany	прозрение
equal	равный, одинаковый; идентичный, равносильный
eradicate	уничтожать
erupt	извергаться
escalate	обострять
essentially	по существу
establish	устанавливать
etched	запечатленный
eternity	вечность
evade	избегать
event	событие (программное)
evidence	доказательство
evident	ясный
exacerbate	обострять
exactly	точно
example	пример
excited	взволнованный
excitedly	взволнованно
excuse	предлог
exhausted	опустошенный
exhaustive	исчерпывающий
expect	ждать
expectations	ожидание
expensive	дорогой
explains	объясняет
explanations	разъяснение
expose	экспонировать
expresses	выражает
expunge	вычёркивать
exquisite	изысканный
extinct	вымерший
extort	вымогать
eyelash	ресничка
eyelid	веко
fabulous	изумительный
faith	вера
familiar	хорошо знакомый
famished	голодный
far	далёкий, дальний, отдалённый
fascinate	очаровывать
fast	быстрый, скорый; неточный, спешащий
fault-tolerant	отказоустойчивость
feast	празднование
fecundity	плодородие
felicity	блаженство
fetters	оковы
fictitious	воображаемый
fiend	злодей
fight back	сдерживать(слезы, смех); сопротивляться, давать отпор;
figure out	сообразить, выяснить, понять, разобраться
figured out	выяснил, понял
film	фотоплёнка
filming and photography	кинофотосъёмка
filthy	грязный
final	завершающий, заключительный, конечный
fine	тонкий, утончённый; прекрасный, превосходный, совершенный
finiteness	конечность
flare	вспышка или язык пламени
flash	вспышка
flavor	вкус
flawless	безупречный
flesh	плоть
flicker out	исчезать
flourish	процветать
flu	разг. грипп
fluently	бегло
fluttering	развевающийся
folder	папка (на компьютере)
forearm	предплечье
forefinger	указательный палец
forehead	лоб
foreshadows	предвещает
forgiven	прощенный
forsaken	брошенный
fractures	перелом
framing	кадрирование
freckle	веснушка
free	свободный, вольный, независимый
frightened	испуганный
fringe	чёлка
front	передний
frown	хмуриться
frustration	расстройство
full	полный
fumigate	дезинфицировать
fun	веселье
function	функция
furniture	мебель
further	дальше
fusion	слияние
futile	бесполезный
gamble	играть в азартные игры
gamma	гамма
gasp	задыхаться
gathering	собрание
gazed	вглядывался
generous	великодушный, благородный, добрый
gentleness	доброта
genuinely	искренне
get along	уживаться, ладить, справляться с делами
get over	справиться, понять, добраться до, перейти, перелезть
give up	сдаться, отказаться, оставить, бросить
glances	взгляды
gland	железа
glass	стеклянный
glimmer	мерцание
glimpse	увидеть мельком
glossy	глянцевый, блестящий
glove	перчатка
glow	отблеск
go by	проходить, проезжать мимо; проходить (о времени)
gold	золото
good	хороший
gossip	сплетня
got off	сошел, покинул
graininess	зернистость
grainy	зернистый
grasp	охватить
great	большой, огромный, крупный
green	зелёный
grievance	жалоба
grind	перемалывать
grip	хватка
groin	пах
groove	ритм
gross	отвратительный
grow	расти
grow up	вырастать, становиться взрослым
grueling	изнурительный
grunting	хрюкать
guilt	вина
hacker	хакер
ham	ветчина
hang out	тусоваться, ошиваться; вывешивать
happy	счастливый
hard	жёсткий, твёрдый; тугой, негибкий, негнущийся
hard disk	жесткий диск
hard-fought	упорный
harmless	безобидный
harnessing	освоение
harsh	строгий
hate	ненависть
hatred	ненависть
haunt	преследовать
hazard	опасность
haze	вуаль
healthy	здоровый
heavy	тяжелый
heel	пятка
helpful	полезный
helpless	беспомощный
hen	курица
hesitation	сомнение
high	высокий; большой, сильный, интенсивный
high availability	высока доступность
high performance	высокая производительность
hilarious	весёлый
hinder	препятствовать
hips	бедра
histogram	гистограмма
honestly	честно
honor	честь
hope	надежда
hopped on	прыгнуть на; вскочить на
horny	возбужденный (сленг)
hospital ward	больничная палата
hot	горячий
huge	гигантский
human	людской, человеческий; социальный, общественный
hunger strike	голодовка
hurl	бросать
husband	муж
huskiest	самый крепкий; самый здоровый
hydrometer	гидрометр
illumination	освещённость
immediately	немедленно
immersed	погруженный
immersion heater	кипятильник
impatient	нетерпеливый
impediment	помеха
imperfections	несовершенство
implementation	реализация
import	импорт
important	важный, значительный, существенный
improbable	неправдоподобный
in advance	заранее
in spite of	несмотря на, вопреки чему-либо
in turn	в свою очередь
inappropriate	неуместный
inchoate	зачаточный
include	включение
inconceivably	непостижимо
indeed	действительно
indelibly	неизгладимо
indignity	оскорбление
indulgence	снисхождение
inescapable	неотвратимый
inextricably	неразрывно
infantry	пехота
inference	вывод
infested	зараженный
infinitesimal	бесконечно малая величина
infra-red photography	инфракрасная фотография
infuriating	приводящий в ярость
inherently	по сути
injure	ранить
innate	врождённый
innocense	невинность
insane	безумный
insecure	ненадежный
inspiration	вдохновение
instigate	подстрекать
intention	намерение
interest	интерес
intervene	вмешиваться
intimate	интимный
intimating	намекающий
intimidating	пугающий
intolerable	невыносимый
introspective	самосозерцательный
invention	изобретение
involuntary	непроизвольный
involvement	вовлечение
irreparable	непоправимый
irritation	раздражение
jaw	челюсть
jealous	ревнивый
jealousy	ревность
joy	радость, счастье; восторг
jubilation	ликование
juncture	соединение
keen	заядлый
keen sense	обостренное чувсво
keeps me up	не дает мне уснуть
kerchief	платок
keyboard	клавиатура
kidney	почка
kind	добрый, любезный, сердечный
kindhearted	добрый, мягкосердечный
knock down	сбить с ног, сносить, разрушать, понижать
knock it off	брось, оставь, отцепись
known	известный
lack	недостаток
lacked	не хватало
lag	медленно тащиться
lamer	ламер
language	язык
lapse	деградировать
large	большой
larynx	гортань
lashed out	обрушился с критикой
last	последний
late	поздний
lay	класть
lazy	ленивый
leaf node	вершина дерева, не имеющая дочерних вершин
leash	поводок
led	приводить
ledger	программа финансового учёта
leech	пиявка
left behind	оставить позади
legal notes	юридическое заявление
legislation	законодательство
lens	объектив
lens angle	угол изображения объектива
let in	впускать
let me down	подводить, разочаровывать
level	уровень
library	библиотека (функций)
license plate	номерной знак
life-cycle	жизненный цикл
light	лёгкий
lighter	зажигалка
lightness	лёгкость
lightweight	простая и компактная (программа)
limber	гибкий
limping	хромающий
line disciplines	протокол линии
line switching	коммутация каналов (линий связи)
line terminator	завершитель строки
lingers	задерживаться
links bar	панель ссылок
list headed by size	список с указанием размера
listen out	прислушиваться
lit	зажечь
literal	литерал
literally	буквально
literate programming	стиль разработки программы, при котором сначала пишется описание будущей программы на естественном языке, которое в процессе разработке разбавляется кодом программы
little	маленький, небольшой; короткий, близкий (о времени, расстоянии)
live cd	загрузочный компакт-диск
liver	печень
load	загружать
load balancing	балансировка нагрузки
loathe	ненавидеть
localhost	локальное имя домена
locket	медальон
log file	журнал сообщений
long	длинный
long gone	след простыл
longing	тоска
look and feel	внешний вид, стиль
loop	цикл
loop body	тело цикла
loopback interface	сетевая заглушка
loosely	свободно
lore	знания
loud	громкий
love	любовь
low	низкий, невысокий; открытый; низкий (об одежде, обуви)
low-level	низкоуровневый
low-level language	язык низкого уровня
lung	легкое
lust	похоть
luxury	роскошный
maid	горничная
maiden	девица
mail	почта
main	главный; важнейший, основной; абсолютный
maintain	поддерживать
maintenance	поддержка
make yourself at home	Чувствуйте себя как дома
malnourished	истощенный
mandatory	обязательный
mankind	человечество
marshall	группировать, упорядочивать
marvelous	удивительный
match	спичка
matrix	матрица
meadow	луг
meals	еда
meaning	значение
measurable	значительный
megapixel	мегапиксель
melancholy	меланхолия
melt	таять
member	член класса (член-переменная класса)
mend	чинить
mention	упоминать
meth	травка
method	метод
milk	молоко
miserable	несчастный
misery	страдание
mist	(лёгкий) туман
mittens	варежки
moderately	умеренно
mohawks	ирокез (стрижка)
molar	коренной зуб
mole	родинка
monotony	однообразие
mood	настроение
most	самый большой, наибольший
mother-in-law	тёща
mouse	мышь
moustache	усы
mug	кружка
murmur	ворчание
mutual	взаимный
nail	ноготь
nape	затылок
napkin	салфетка
narrow	узкий
nasty	неприятный
national	народный, национальный, государственный
navel	пупок
near	близкий
neck	шея
needles	иглы
network	сеть
new	новый
next	следующий; будущий; ближайший, соседний
no swearing!	не ругаться!
notebook	ноутбук
noticed	заметил
notion	понятие
notorious	печально известный
nourished	сытый
nourishment	питание
nun	монахиня
nuptials	бракосочетание
nurturing	воспитание
obituaries	некрологи
object	объект
oblique photography	перспективная фотосъёмка
obliterate	вычёркивать
obscure	неясный
obscurity	неизвестность
obsession	одержимость
obsidian	обсидиан
obvious	очевидный
occurred to me	пришло мне в голову
offer	предлагать
old	старый
only	единственный
open sore	открытая рана
opinions	мнение
opposite	напротив
out of reach	вне досягаемости
outfit	экипировка
outlet	отдушина
outskirts	окраина
overdevelopment	перепроявление
overexposure	передержка
overreach	перехитрить
ovule	яйцеклетка
package	пакет (библиотека)
pain	боль
pale	бледный
palm	ладонь
pang	внезапная острая боль
pants	штаны
parallax	параллакс
parrot	попугай
particular	конкретный
passage	проход
passing through	проезжая, проходя через
passion	страсть
pathetic	жалкий
patience	терпение
patient	терпеливый
peas	горох
pelvis	таз
pending nuptials	надвигающаяся свадьба
perceive	воспринимать
perception	восприятие
perfection	совершенство
perky	бойкий
permanent	постоянный
perspective	перспектива
persuasive	убедительный
pesky	амер. разг. надоедливый
pestilence	эпидемия
photometric measurement	фотометрирование
pierce	пронзать
pig	свинья
pillar	колонна
piston	поршень
pitiful	ничтожный
pity	жалость
plague	чума
platform	платформа
plead	умолять
pleasant	приятный
plenitude	изобилие
plenty	множество
plethora	изобилие
poached	в смятку
poor	бедный
pork	свинина
possible	вероятный, возможный
poultry	домашняя птица
pounding	стук
poverty	бедность
precisely	точно
pretentious	притязательный
pretext	предлог
prey	добыча
prick	прокалывать
primal	первобытный
print	отпечаток
private	частный, личный, персональный, приватный
process	процесс
processing	обработка
profitable	прибыльный
profound	глубокий
programmer	программист
programming	программирование
programming language	язык программирования
promise	обещание
promises	обещания
prone	склонный
prosody	интонация
prosperity	процветание
protrude	торчать
pull me under	затяни меня на дно
pupil	зрачок
pure	чистый
purposes	цель
purse	кошелёк
pursue	преследовать
put you down	унижать
quash	отменять
quell	подавлять (эмоции)
query language	язык запросов
quick	быстрый
quiet	спокойный
quietly	спокойно
quirks	особенности
quirky	причудливый
quite	вполне
quivering	дрожание
quivering voice	дрожащий голос
quorum	кворум
ragged	рваный
rails	рельсы
random	случайный
random number	случайное число
range of exposure	диапазон экспонирования
rare	редкий
ready	готовый, подготовленный, приготовленный
real	реальный, действительный, подлинный, истинный
reassuring	обнадеживающее
rebel	бунтарь
recent	недавний, последний; новейший, свежий, современный
reclaim	восстановление
red	красный
reeking	зловонный
reflection	рефлекс (отсвет)
reflex	блик
refuse	отказывать
regarding	в отношении
rehearsal	репетиция
relentless	непреклонный
relevant	относящийся к делу
reliance	уверенность
remain	оставаться
remorse	раскаяние
replenish	подкреплять/подкрепить
replica	точная копия
reproach	упрекать
reproduce	воспроизводить/воспроизвести
reset	сброс
responsible	ответственный
retina	сетчатка
reveal	обнаруживать
revulsion	отвращение
rib	ребро
rice	рис
rich	богатый
ridiculous	нелепый
rifle	винтовка
rift	трещина
rifts	разногласия
right	правильный
right-wing	правых взглядов (полит.)
riot	бунт
rival	соперник
riveted	приковывать
roam	бродить
robust	крепкий
rod	прут
rotten	гнилой
rotting	гниль
round	круглый
rub	натирать
rug	коврик
ruse	уловка
rusty	ржавый
sadness	печаль
safe	безопасный
sail away	отплывать, уплывать
sake	польза
saltine	печенье с солью
same	одинаковый
sand	песок
satisfy	удовлетворять
savage	свирепый
scapula	лопатка
scars	шрамы
schedule	расписание
scowl	хмуриться
scrape up	отчищать, наскребать (деньги, очки)
screw up	испортить, напортачить, провалить
screwdriver	отвёртка
scuffle	драка
seal	запечатывать
seamless	плавный
seducing	соблазнять
seems	оказывается
seized	захваченный
self discovery	самопознание
self-appointed	самопровозглашенный
selfish	эгоистичный
sempiternal	вечный
senselessly	бессмысленно
senses	чувства
sensitivity	чувствительность
sensitizing	сенсибилизация (фото)
serious	серьёзный
settle	успокаиваться
severe	суровый
sewage	сточные воды
shades	тени
shading	светотень
shaft	ствол
shapeless	бесформенный
shattered	раздробить
she is an idiot	она идиотка
sheer	абсолютный
shelf	полка
shepard	пастух
shin	голень
shivering	дрожащий
shoe	башмак
shore	берег
short	короткий
shrimp	креветка
shut up	заткнись, замолчи
shutter	затвор
shy	застенчивый
sidewalk	тротуар
sigh	вздох
sight	взгляд
sign in	войти, зарегистрироваться
signature	подпись
silent treatment	молчанка, бойкот
silly	глупый
simple	несложный, простой, лёгкий
simply put	проще говоря
since	с тех пор
sincerely	искренне
sincerity	искренность
single	один; единственный; отдельный; единичный
sink or swim	была не была, пан или пропал
slab	плита
slave	раб
sleek	гладкий
sleeve	рукав
slightly	слегка
slipcover	чехол для мебели
slipping	скольжение
sloppy	небрежный
slosh around	плескаться
slow	медленный, тихий; медлительный, неторопливый, постепенный
small	маленький, мелкий; небольшой
smirk	ухмылка
sneak up	незаметно подкрастся
sneakers	кроссовки
soaked	пропитанный
sober	трезвый
social	общественный; социальный, коммуникабельный, общительный
software	программное обеспечение
solely	исключительно
soliciting	настойчиво просить
son of a gun	негодник; паршивец
soothes	успокаивать
sophisticated	изощренный
sore	больной
spare me	пощадите меня
sparkle	блеск
spearhead	возглавлять
special	особый, особенный, специальный
specific gravity	удельный вес
speech	речь
spill	проливать
spills out	выплескивается
splendid	великолепный
splinter	заноза
spoons	ложки
spot	какое-то определенное место
spotless	безупречный
spread out	растягивать, развертывать, расширять
spur	побуждать
squat	приземистый
squeal	визжать
squids	кальмары
squinted	прищурился
stab me	ударь меня
staff	штат
staring	пялящийся
state-of-the-art	передовой
statement	оператор
static variable	статическая переменная
steal	воровать
stereo photography	стереосъёмка
sticky piston	липкий поршень
stiffened	окоченевший
stifle	подавлять
still at large	всё ещё на свободе
stirring	помешивание
stocking	чулок
stone	камень
stop it	прекрати
stove	печь
straightway	сразу
strand	нить
strapped down	стянуть
stride	большой шаг
strive	стараться
stroke of luck	улыбка фортуны, удача
stroll	прогулка
strong	сильный, решительный, непоколебимый, стойкий, храбрый
struggle	борьба
stubble	щетина
stuck	застрять
stumble	спотыкаться
stutter	заикание
sublime	величественный
subsequently	впоследствии
sudden	внезапный
suddenly	внезапно
suffering	страдание
suing	преследовать в судебном порядке; подавать в суд, возбуждать иск, предъявлять иск
suitable	подходящий
summon	призывать
sunbeams	солнечные лучи
supporter	сторонник
supposedly	предположительно
suppress	подавлять
sure	уверенный; верный, безошибочный; надёжный
surely	непременно
surge of confidence	прилив уверенности
surgical	хирургический
surpassed	превосходить
suspect	подозревать
suspicious	подозрительный
sustained	непрерывный
sweat	пот
sweet	сладкий
syllable	слог
sympathy	сочувствие
synchronization	синхронизация
table	таблица
taint	пятно
take your time	Не торопитесь
tamper	портить
tangible	осязаемое
tarmac	взлетная полоса
tasty	вкусный
tedious	утомительный
temple	висок
tender	нежный
tending	ухаживающий
tense	напряженный
terrible	ужасный
tether	привязать
thankful	благодарный
therefore	поэтому
thick	толстый
thigh	бедро
thirsty	испытывающий жажду
thorax	грудная клетка
thorn	шип
thoughtless	безрассудный
threat	угроза
thrill	трепет
thugs	бандиты
tie	галстук
tied	связанный
till	до
tinkerer	ремонтник
to load a magazine	заряжать/зарядить кассету
to top it all off	в довершение ко всему
toe	палец (на ноге)
together	вместе
tonsils	гланды
took off	снял
torn	разорванный
tossing	встряхивать
tough	трудный
towards	к, по направлению к; по отношению к; для, с тем, чтобы; около (часа)
towel	полотенце
traitor	предатель
tramp	бродяга
treat	обращаться
tree	дерево
tremble	дрожать
trembling	дрожь
trepidation	дрожь
tribute	дань
trifle	пустяк
trolley	вагонетка
troubled	беспокойный
trousers	брюки
trump	превзойти
trunk	торс
trust	доверие
tug	рывок
turned out	оказалось
twisted	запутанный
ubiquity	вездесущность
ultra-close-up photography	макросъёмка
ultrahigh-speed photography	сверхскоростная фотография
unbearable	невыносимый
unchain	освобождать
underneath	внизу
undertow	ловушка, ловушка
uneasy	тревожный
uninhabited	необитаемый
unpredictable	непредсказуемый
unravel	разгадывать
unsettling	тревожащий
up-and-up	без обмана
upset	расстройство
urge	побуждение
urgency	срочно
urgent	настойчивый
urp	рыгать
usual	обыкновенный, обычный
uterus	матка
vague	смутный
valor	доблесть
vanish	исчезать
vanquish	подавлять
vaporize	испарять
variable	переменная
various	различный, разный, разнообразный
vast	громадный
vengeance	месть
ventured	решиться
vertebra	позвонок
viral	вирусный
virtual synchrony	виртуальная синхронность
virtue	достоинство
visceral	интуитивный
vulnerable	уязвимый
waist	талия
waitress	официантка
wanderer	странник
wandering	блуждающий
ward	опека
warm	теплый
wart	бородавка
waste	растрата
water	вода
watermelon	арбуз, арбуз
weak	слабый
wealthy	богатый
weary	утомлённый
web-master	веб-мастер
web-page	веб-страница
web-site	веб-сайт
weddings	свадьба
weeping	рыдание
weird	странный
what's it to you?	Какая тебе разница? Тебе то какое дело?
whatever	любой
wheat	пшеница
whence	откуда
whine	плакаться
whisked	быстро двинулся
whiskers	бакенбарды
whispers	шептать
white	белый
wide	широкий
widespread	широко распространённый
will	желание
winding	извилистый
wisdom	мудрость
wise	мудрый
within	в пределах
witnesses	свидетели
witty remark	остроумное замечание
woke me up	разбудил меня
wolf	волк
wooden	деревянный
wool	шерстяной
worn	изношенный
worried	озабоченный
worship	поклоняться
worst	наихудшее
worth	стоимость
worthy	достойный
wounds	рана
wrath	гнев
wrist	запястье
wrists	запястья
yells	вопить
young	молодой, юный; недавний, новый
zombie	зомби
